11111111111111111
1000000C000000001
1E0000000000000P0
11111111111111111
