111111111
1000000011
110000001
1000001
1111111111111111
1000000011
110000001
1000001
1111111111111111
1000000011
110000001
1000001
1111111111111111
1000000011
110000001
1000001
1111111111111111
1000000011
110000001
1000001
1111111111111111
1000000011
110000001
1000001
1111111111111111
1000000011
110000001
1000001
1111111111111111
1000000011
110000001
1000001
1111111111111111
1000000011
110000001
1000001
1111111111111111
1000000011
110000001
1000001
1111111111111111
1000000011
110000001
1000001
1111111111111111
1000000011
110000001
1000001
1111111111111111
1000000011
110000001
1000001
1111111111111111
1000000011
110000001
1000001
1111111111111111
1000000011
110000001
1000001
1111111111111111
1000000011
110000001
1000001
1111111111111111
1000000011
110000001
1000001
1111111111111111
1000000011
110000001
1000001
1111111111111111
1000000011
110000001
1000001
1111111111111111
1000000011
110000001
1000001
1111111111111111
1000000011
110000001
1000001
1111111111111111
1000000011
110000001
1000001
1111111111111111
1000000011
110000001
1000001
1111111111111111
1000000011
110000001
1000001
1111111111111111
1000000011
110000001
1000001
1111111111111111
1000000011
110000001
1000001
1111111111111111
1000000011
110000001
1000001
1111111111111111
1000000011
110000001
1000001
1111111111111111
1000000011
110000001
1000001
1111111111111111
1000000011
110000001
1000001
1111111111111111
1000000011
110000001
1000001
1111111111111111
1000000011
110000001
1000001
1111111111111111
1000000011
110000001
1000001
1111111111111111
1000000011
110000001
1000001
1111111111111111
1000000011
110000001
1000001
1111111111111111
1000000011
110000001
1000001
1111111111111111
1000000011
110000001
1000001
1111111111111111
1000000011
110000001
1000001
1111111111111111
1000000011
110000001
1000001
1111111111111111
1000000011
110000001
1000001
1111111111111111
1000000011
110000001
1000001
1111111111111111
1000000011
110000001
1000001
1111111111111111
1000000011
110000001
1000001
1111111111111111
1000000011
110000001
1000001
1111111111111111
1000000011
110000001
1000001
1111111111111111
1000000011
110000001
1000001
1111111111111111
1000000011
110000001
1000001
1111111111111111
1000000011
110000001
1000001
1111111111111111
1000000011
110000001
1000001
1111111111111111
1000000011
110000001
1000001
1111111111111111
1000000011
110000001
1000001
1111111111111111
1000000011
110000001
1000001
1111111111111111
1000000011
110000001
1000001
1111111111111111
1000000011
110000001
1000001
1111111111111111
1000000011
110000001
1000001
1111111111111111
1000000011
110000001
1000001
1111111111111111
1000000011
110000001
1000001
1111111111111111
1000000011
110000001
1000001
1111111111111111
1000000011
110000001
1000001
1111111111111111
1000000011
110000001
1000001
1111111111111111
1000000011
110000001
1000001
1111111111111111
1000000011
110000001
1000001
1111111111111111
1000000011
110000001
1000001
1111111111111111
1000000011
110000001
1000001
1111111111111111
1000000011
110000001
1000001
1111111111111111
1000000011
110000001
1000001
1111111111111111
1000000011
110000001
1000001
1111111111111111
1000000011
110000001
1000001
1111111111111111
1000000011
110000001
1000001
1111111111111111
1000000011
110000001
1000001
1111111111111111
1000000011
110000001
1000001
1111111111111111
1000000011
110000001
1000001
1111111111111111
1000000011
110000001
1000001
1111111111111111
1000000011
110000001
1000001
1111111111111111
1000000011
110000001
1000001
1111111111111111
1000000011
110000001
1000001
1111111111111111
1000000011
110000001
1000001
1111111111111111
1000000011
110000001
1000001
1111111111111111
1000000011
110000001
1000001
1111111111111111
1000000011
110000001
1000001
1111111111111111
1000000011
110000001
1000001
1111111111111111
1000000011
110000001
1000001
1111111111111111
1000000011
110000001
1000001
1111111111111111
1000000011
110000001
1000001
1111111111111111
1000000011
110000001
1000001
1111111111111111
1000000011
110000001
1000001
1111111111111111
1000000011
110000001
1000001
1111111111111111
1000000011
110000001
1000001
1111111111111111
1000000011
110000001
1000001
1111111111111111
1000000011
110000001
1000001
1111111111111111
1000000011
110000001
1000001
1111111111111111
1000000011
110000001
1000001
1111111111111111
1000000011
110000001
1000001
1111111111111111
1000000011
110000001
1000001
1111111111111111
1000000011
110000001
1000001
1111111111111111
1000000011
110000001
1000001
1111111111111111
1000000011
110000001
1000001
1111111111111111
1000000011
110000001
1000001
1111111111111111
1000000011
110000001
1000001
1111111111111111
1000000011
110000001
1000001
1111111111111111
1000000011
110000001
1000001
1111111111111111
1000000011
110000001
1000001
1111111111111111
1000000011
110000001
1000001
1111111111111111
1000000011
110000001
1000001
1111111111111111
1000000011
110000001
1000001
1111111111111111
1000000011
110000001
1000001
1111111111111111
1000000011
110000001
1000001
1111111111111111
1000000011
110000001
1000001
1111111111111111
1000000011
110000001
1000001
1111111111111111
1000000011
110000001
1000001
1111111111111111
1000000011
110000001
1000001
1111111
