11111111111
1E00C00E0P1
10C0P0C0001
11111111111
