111111111111111111111111
10P000000000000000E000C1
111111111111111111111111
